slug - лентяй
bludgeon - дубинка
tombstone - надгробная плита
orchastrated - организовал
jaded - измученный
detested - ненавидимый
confide - доверять
tuck - складка
hoof - копыто
knuckle - кулак
diversity - разнообразие
invaded - вторгся
apprentice - подмастерье
gullet - пищевод
ingest - проглатывать
bygones - былое
wacky - чокнутый
remnant - остаток
toddler - ребенок, начинающий ходить
taunting - ядовитый
arsonist - поджигатель
reprieve - передышка
soldering - паяльный
owl - сова
accelerate - ускорять
devious - хитрый
addled - испорченный
raving - бесноватый
persuasive - убедительный
impale - прокалывать
obstacle - препятствие
slay - сражать
clamor - ропот
reproach - упрекать
abdomen - живот
viscosity - вязкость
cabal - интрига
spry - проворный
kettle - чайник
bargained - выторговал
flock - стадо
thrive - процветать
tow - буксировать, тащить
traipse - тащиться
chisel - резец
encumbered - обремененный
decimated - истребленный
scallywag - бездельник
culprit - преступник
dimming - затемнение
dwell - обитать
waylaid - подкараулил
acquainted - знакомый
chastity - целомудрие
leash - привязь
lean - опираться
consort - гармонировать, обращаться
mayhem - нанесение увечья
coerce - принуждать
smother - душить
remorse - раскаяние
squad - команда
mettle - лихость
quaint - причудливый
sustain - поддерживать
plump - полнеть
plums - сливы
clot - сгусток
constellation - созвездие
squat - приземистый
agenda - повестка дня
parlay - держать пари
penance - покаяние
scourers - мочалки
vanquish - побеждать
reckoning - расплата
trespassing - нарушение
abacus - счеты
fragrant - душистый
ingress - вход
weasels - хорьки
frowning - угрожающий
ward - подопечный
wane - убывать
frequently - часто
covet - жаждать
cog - зубец
malicious - злонамеренный
ditch - ров
aisle - придел
skid - занос
residing - проживающих
jog - бегать трусцой
dagger - кинжал
cassock - ряса
wretch - негодяй
stray - бездомный, плутать
speck - пятнышко
ferocity - свирепость
straw - солома
scamper - носиться
comb - расческа
uttered - сказанный
miseries - невзгоды
deviate - отклоняться
dimwit - тупица
compassion - сострадание
abominations - мерзости
prominent - видный, известный
roast - жарить
ledge - уступ
hatch - люк
abbey - аббатство
perform - выполнять
stump - пень
daisy - маргаритка
deck - колода
limb - конечность
impose - навязать
launch - запуск
illicit - незаконный
gloat - злорадствовать
eluding - ускользает
mining - добыча полезных ископаемых
flatter - льстить
reprimand - выговор
sonar - ультразвуковой локатор
severely - сильно
vat - чан
cantina - столовая
pat - похлопывание
diluted - разбавленный
thicken - утолщать
crawl - ползать
at once - однажды
tangle - запутывать
remedy - средство
condemned - приговоренный
facilitate - содействовать
fossils - ископаемые
orderlies - санитары
lurking - скрываясь
glance - взгляд
frustrates - расстраивает
nozzle - сопло, насадка
maimed - искалеченный
unanimous - единодушное
endeavor - предприятие
cuttlefish - каракатица
sprung - захмелевший, треснувший
cemetery - кладбище
acolytes - служитель
dank - промозглый
ultimate - окончательный
ambushes - засады
irreversible - необратимый
strangling - задыхающийся
tenuous - разреженный
curricular - внеклассных
fling - брыкаться
zipper - молния
restraint - сдержанность
ingenuity - изобретательность
anticipate - предвидеть
hawk - ястреб
awry - неправильно, косо
resembling - похожий
hunch - ломоть, предчувствие
wallop - поколотить
extinction - вымирание
curse - проклятие
perceive - воспринимать
facial - лицевой
flair - чутье
dungeon - темница
gutter - водосточный желоб
tremble - дрожать
weep - плакать
retaliation - возмездие
whammy - сглаз
interagation - опрос
porky - сальный
deliberating - обсуждение
hunk - ломоть
dainty - лакомство
devastated - опустошенный
tissue - ткань
lad - парень
escapade - авантюра
slob - неряха
rascal - мошенник
tailpipe - выхлопная труба
incision - надрез
tender - нежный
dull - тупой
firebugs - поджигатели
unicorn - единорог
boost - повышение
indignation - возмущение
scholar - ученый
chivalrous - рыцарский
prosperity - процветание
fragile - хрупкое
plague - чума
barrel - бочка
allies - союзники
villain - негодяй
lapdog - болонка
vixen - мегера
intimidate - запугивать
spree - веселье
compels - принуждает
chevy - гнаться
niece - племянница
hethen - язычник
thud - глухой звук
impact - влияние
repulsive - отталкивающий
stomp - топать
amplify - усиливать
gills - жабры
revive - возрождать
stunned - ошеломлен
whittle - строгать
rampage - буйство
cordially - сердечно
swell - набухать
indigestions - расстройства желудка
inflame - воспаляться
carve - резать
impart - придавать
belay - отставить
blossom - цвести
crud - падла
feather - перо
brawling - драки
fuzzy - нечеткий
scrawny - тощий
grumpy - сердитый
faculties - способности
instant - мгновенный
swagger - развязность
snivelling - хныкать
ramified - разветвленный
shrivel - высыхать
implication - импликация
bullied - издеваются
devote - посвятить
bark - лай
harbor - гавань
squabbling - склок
chimney - дымоход
cliff - утес, крутой обрыв
excel - превосходить
intrepid - бесстрашный
fret - размывать
dashboard - приборная доска
sturdy - крепкий
impartial - беспристрастный
cherish - лелеять
boundary - граница
mellifluous - сладкозвучный
looting - мародерство
virtue - добродетель
rambling - бессвязный, бродячий
vigorous - бодрый
implore - умолять
imply - подразумевать
abetted - подстрекательство
runt - коротышка
instill - внушать
yield - уступать, доходность
sprouted - проросли
profound - глубокий
outlost - пережить
shore - берег
blackout - затемнение
reckon - рассчитывать
groggy - слабый
chaperone - сопровождать
unleash - развязать
vouch - поручиться
depicted - изображенный
resent - возмущаться
hissing - шипение
spike - колос, шип
contagious - заразный
titillate - щекотать
cortex - кора головного мозга
dabble - плескаться
notorious - пресловутый
pellets - гранулы
emerge - всплывать
absolve - освобождать
delinquent - преступник
carnage - резня
menace - угроза
mallet - колотушка
dismay - испуг
peril - подвергать опасности
desecrate - осквернять
astray - заблудившись
rife - изобилующий
goofy - бестолковый
concussion - сотрясение
solemn - торжественный
mundane - мирской
bullies - хулиганами
contamination - загрязнение
keen - острый
lure - приманка
retribution - воздаяние
snatch - урвать
stellar - звездный
mustard - горчичный
vault - свод, склеп, погреб
bulletproof - пуленепробиваемый
impeccable - безупречный
eloquently - красноречиво
aspersion - клевета
jiggle - покачивать
atonement - расплата
guile - коварство
ardent - пылкий
exile - ссыльный
synergy - взаимодействие
ensue - вытекать, следовать
monks - монахи
strain - нагрузка
decanter - графин
booing - освистала
oath - присяга
banishment - изгнание
stage - этап, стадия
thug - головорез
occupied - занятый
unscathed - невредимый
crusade - крестовый поход
specimen - образец
reluctant - неохотный
accommodate - вмещать
flu - грипп
breakout - разразиться
latency - задержка
though - хоть
fuse - предохранитель
abide - соблюдать
slash - хлестать, сокращать
tension - напряженность
vexing - раздражающий
pantry - кладовая
wealth - богатство
utterly - вконец, крайне
feasible - выполнимый
jaw - челюсть
dummy - манекен
skew - скос
farewell - прощальный
poverty - бедность
slurp - чавкать
affections - привязанностей
apprehension - опасение
grasp - схватывание
flare - вспышка
sap - живица
hushed - приглушенным
nook - закоулок
eradicate - искоренять
waive - отказываться
prejutice - предубеждение
collaborative - совместный
sewer - сточная труба
malware - вредоносные программы
dickens - черт
trunk - хобот,
bid - предложение
aid - помощь
afar - издалека
sobriquet - кличка
imminent - неизбежный
ogle - строить глазки
slab - плита
penitentiary - исправительный
mansion - особняк
envious - завистливый
inevitable - неизбежный
shrimp - креветка
wreck - развалина
captives - пленники
lace - шнурок
quarry - карьер
cradle - колыбель
mute - немой
overture - увертюра
tiresome - утомительный
curdling - леденящий, свертываться
bedrock - почва
inflict - причинить
bewitch - заколдовывать
scram - катись
demented - безумный
ambush - засада
sneer - насмешка
jolly - веселый
brass - латунь
leather - натуральная кожа
troops - войска
bump - удар
ponder - обдумывать
cahoot - соучастие
accomplance - соучастник
soggy - нудный
vicious - порочный
squirm - извиваться
restrictive - ограничительный
worship - поклонение
fornicate - блудить
reliable - надежный
cork - пробка
condolences - соболезнование
torment - мучение
fugitive - беглец
salvation - спасение
obtain - получать
arrogance - высокомерие
curtain - занавес
spook - привидение
flippant - легкомысленный
arcane - тайный
affair - дело
abyss - бездна
mouthfeel - вкусового
tumors - опухоли
quarrel - ссора
kipper - копченая рыба
mittens - рукавицы
pretzel - кренделек
perpetrated - совершаемых
endorce - одобрять
tar - деготь
reeling - наматывание
dread - страшиться
courting - ухаживает
hectic - беспокойный
gore - запекшаяся кровь
geezer - старикашка
infirmary - лазарет
recess - углубление
juncture - стык, соединение
courage - храбрость
astound - изумлять
paddling - перемешивание
loony - полоумный
mongering - спекуляция
crack - трещина
skedaddled - драпать
depraved - развращенный
esteem - почитать
rejoice - радоваться
hack - мотыга
iffy - сомнительный
heist - ограбление
forsake - оставлять
conquer - завоевать
pinch - зажимать, щипать
sack - мешок
nappy - подгузник
swag - халява
posh - шикарный
weasel - ласка
deception - обман
goon - громила
stifled - подавленный
retain - удерживать, приглашать
astonishing - удивительный
fabulous - невероятный
bounty - щедрость
dapper - щеголеватый
manor - поместье
magnificent - великолепный
sassy - нахальный
thincessant - непрекращающийся
egress - выход
gutted - потрошат
bodega - винный погребок
lackadaisical - апатичный
hassle - стычка
constitute - составлять
dibs - фишки
compound - соединение
warden - смотритель
walrus - морж
bliss - блаженство
peer - вглядываться
descend - спускаться
thus - таким образом
meddling - надоедливый
