groggy – слабый
spook – привидение
synergy – взаимодействие
impact – влияние
tremble – дрожать
fabulous – невероятный
ferocity – свирепость
anticipate – предвидеть
hatch - люк
ardent – пылкий
endeavor – предприятие
hushed – приглушенным
overture – увертюра
carnage – резня
unscathed – невредимый
carve – резать
curtain – занавес
salvation - спасение
slug – лентяй
bulletproof – пуленепробиваемый
skew – скос
coerce – принуждать
scallywag – бездельник
iffy – сомнительный
Kipper – копченая рыба
tuck – складка
confide – доверять
contagious – заразный
lure – приманка
soldering – паяльный
cog – зубец
bedrock – почва
unleash – развязать
loony – полоумный
leash - привязь
fornicate – блудить
wallop – поколотить
dibs – фишки
sack – мешок
ogle – строить глазки
esteem – почитать
vicious – порочный
dummy – манекен
boost – повышение
thicken – утолщать
reluctant – неохотный
bump – удар
escapade – авантюра
curse – проклятие
orchastrated – организовал
breakout – разразиться
squabbling – склок
brawling – драки 
sturdy – крепкий
bid – предложение
flair – чутье
flatter – льстить
jaded – измученный
virtue – добродетель
intimidate – запугивать
jog -  бегать трусцой
posh – шикарный
afar – издалека
affections – привязанностей
bullied – издеваются
prejutice – предубеждение
faculties – способности
astonishing – удивительный
ward – подопечный
trunk – хобот, 
torture  - пытки
squat – приземистый
launch – запуск
tailpipe - выхлопная труба
belay - отставить
endorce – одобрять
arsonist – поджигатель
firebugs – поджигатели
vouch – поручиться
bygones – былое
slob – неряха
ware  - изделия
aisle – придел. 
Fuse – предохранитель
Scram – Катись
Curse – проклятие
Covet – жаждать
Illicit – незаконный
Exile – ссыльный
Penitentiary – исправительный
Remnant – остаток
Thrive – процветать
ABIDE – соблюдать
Redeem  - выкупать
Stump – пень
Spry – проворный
Spree – веселье
Unicorn – единорог
Ditch – ров
Lean – опираться
Hassle – стычка
Mallet – колотушка
Bullies – хулиганами
Plump -  полнеть
Troops – войска
Vixen – мегера
Abacus – счеты
Menace – угроза
Apprehension – опасение
Fugitive – беглец
Gutter - водосточный желоб
Dull – тупой
Squirm – извиваться
Wacky – чокнутый
Lapdog – болонка
Instill – внушать
Wealth – богатство
Ambushes – засады 
Forged  - кованый
Emerge – всплывать
Peer – вглядываться
Accelerate – ускорять
Occupied – занятый
Indignation – возмущение
Goofy – бестолковый
Abyss – бездна
Poverty – бедность
Prosperity – процветание
Ambush – засада
Bodega - винный погребок 
Snatch – урвать
Dabble – плескаться
Concussion – сотрясение
Deception - обман
Retribution -  воздаяние
Pinch – зажимать, щипать
Taunting – ядовитый
Instant – мгновенный
Dagger – кинжал
Encumbered – обремененный
Bargained – выторговал 
Gloat – злорадствовать 
Cassock – ряса
Abbey – аббатство 
Reckoning  - расплата
Monks – монахи
Thug – головорез 
Jiggle – покачивать
Inflict – причинить
Stunned – ошеломлен
Devastated – опустошенный
Mustard – горчичный
Mittens – рукавицы
Sewer - сточная труба
Sap – живица
Gutted – потрошат
Trespassing – нарушение
Niece – племянница
Bark – лай
Scamper – носиться
Pat – похлопывание
Recess – углубление
Oath – присяга
Atonement – расплата
Mettle – лихость
Ingenuity – изобретательность
Lackadaisical – апатичный
Compassion – сострадание
Guile – коварство
Dwell – обитать
Resent – возмущаться
Accomplance – соучастник
Owl – сова
sonar -  ультразвуковой локатор
tumors – опухоли
depraved – развращенный
diluted – разбавленный
feasible – выполнимый
comb – расческа
aid – помощь 
abide – соблюдать
abetted – подстрекательство
specimen – образец
sustain – поддерживать
culprit – преступник
tissue – ткань
vexing – раздражающий
infirmary – лазарет
obstacle – препятствие
occupied – занятый
fragile – хрупкое
envious – завистливый
crusade - крестовый поход
plague – чума
jolly – веселый
straw – солома
paddling – перемешивание
dainty - лакомство
glance - взгляд
quarry - карьер
geezer - старикашка
outlost - пережить
remorse - раскаяние
notorious - пресловутый
ponder - обдумывать
heist - ограбление
chevy - гнаться
ponder - задуматься
reckoning - расплата
reckon - рассчитывать
sprouted - проросли
pretzel - кренделек
soggy - нудный
shore - берег
though - хоть
thincessant - непрекращающийся
allies - союзники
walrus - морж
vigorous - бодрый
knuckle - кулак
weasels - хорьки
deliberating - обсуждение
unanimous - единодушное
fret - размывать
blossom - цвести
apprentice - подмастерье
reproach - упрекать
restraint - сдержанность
weep - плакать
clot - сгусток
shrivel - высыхать
wreck - развалина
torment - мучение
