salutary - целительный
bandwidth - пропускная способность
hike - поход, подъем
reverend - почтенный, преподобный
frown - нахмуриться
sway - раскачивание
brim - край
salvo - залп
nonfiction - документальная литература
whereabouts - местонахождение
inning - подача
infertility - бесплодие
taunt - насмешка
typo - опечатка
roost - насест
exiting - выход
markdown - уценка
cert - верняк
tenure - владение
pork - свинина
perky - самоуверенный
binging - разбрасывать деньги налево
caviar - икра
clairvoyant - ясновидящий
casing - кожух, оболочка
carnivore - плотоядное животное
nascent - рождающийся
chomp - чавкать
incest - кровосмешение
unity - единство
maul - кувалда, терзать
recuse - самоотвод
tentative - предварительный
blueprint - план, проект
objection - возражение
erode - разъедать
hurricane - ураган
torrential - проливной, обильный
reconcile - примириться
faucet - кран
corroborate - подкреплять
inveigle - заманивать
snot - сопли
tuition - обучение
swivel - поворотный
contradict - противоречить
subside - утихать
regal - царственный
alienate - отчуждать
plain - гладкий, простой
detection - обнаружение
rigmarole - канитель
shuffle - шарканье
prolong - продлить
pristine - нетронутый
coitus - совокупление
cognition - познание
craftsmanship - мастерство
abduct - похищать
pitch - подача
snapshot - снимок
precedence - старшинство
whimsical - капризный
alleviate - смягчать
