adhere - придерживаться
slightly - немного
subtle - тонкий
capped - ограничен
frenzy - безумие
bloom - расцвет, цветение
masticate - пережевывать
abrasion - ссадина
ostrich - страус
wrangler - спорщик
preen - прихорашиваться
scorch - подгорать
tune - мелодия, настраивать
palpable - осязаемый
perdition - погибель
disgruntled - раздраженный
recoil - отдача
ambient - окружающий
tutor - репетитор
humidity - влажность
chafing - натирание
rowdy - дебошир
immense - огромный
density - плотность
jade - нефрит
crotch - промежность
inlay - инкрустация
haptic - тактильный
rig - установка
diversion - отвлечение
remand - возвращение под стражу
henceforth - отныне, в дальнейшем
orb - шар
